11111111111111111111111111111111111111111111111111111111111
10000000000000000000000100000100000000000000000000000110000
1000ZNX0000000000000000100000100000000000000000000001001110
10100100100000000000000000000000000000000000000011001011110
1000000000000000000000000010000000000000000000001111101D110
10011I1100000000000010000010000000000Z000000000010000010110
10000000000000000000000000000000000000000000000010000010110
10000100000000000000000100000100000000000000000010111010110
10010001000000000000000100000100000000000000000010101000010
1000000000000000000000000000000000000000N000000000001111110
10000000000000000000000000000000000000000000000000000000000
10000000000000000000000010000000000000000000000000000000000
11111111111111111111110000000000000000000000000000000111000
00000000000000000000011000000000000000000000001000100111000
00000000011110000000001000000000000001100000001000100111100
00000000022113000000001100000000000111111000000000000111100
00000000011113000000000110000000000111111000000000010111000
00000000011110000000000010000000000111111001000000000110000
00000000010010000000000010000000000111111000000000000110000
00000000000000000000000010000000011111111100000000000100000
00111111111000000000000011000000011111H11100001000100000000
00101010101111111111111111100000000001000000001000100000000
00100000000000000000000000001110000000000000000000000000000
00100000000000000000000000001110000000000000000000000000000
00100000000000000000000000001110000P00000000001000100000000
00100000001111111111111111100100000000000000001000100000000
00111000110000010000000001100000000000000000000000000000000
00001000100000000000000011000000000000000010000000000000000
00001000100000000000000010000000000000000000000000000000000
00001000100000000000000010000000000000000000000000000000000
0001100011000000000000001000000000000000Z000000000000000000
00010000010000000000001110000000000000000000000000000000000
00010000010000000000001000000000000000000N00000000000000000
00010000010000000000001000000000000000000000000000000101000
000100V00100000000000010000100010000000000000000000000T0000
00011111110000000000001000000000000000000000000000000101000
00000000000000000011111000000000000000X00000000000000000000
00000000000000111110000000000000000000000000000000000000000
10001111111111100000000000010001000000000000000000000000000
10011000000000000000000000000000000000000000000000000000000
101100000000000000000X000000000000000000000Z000000000000000
11100000000000000000000000000000000000000000000000000000000
10000000000000000000000000000000000000000000000000000000000
11111111111111111111111111111111111111111111111111111111111
